0000000000
0000000000
0000000000
0000000000
0000400000
0000212000
0000004000
0000000000
0000000000
0000000000